00000000000000000000000000000000000000000000000000000000000000000000000000000000000000000000000000000000000000000000000000000000000000000000000000000000000000000000000000000000000000000000000000000000000000000000000000000000000000000000000000000000000000000000000000000000000000000000000000000000000000000000000000000000000000000000000000000000000000000000000000000000000000
00000000000000000000000000000000000000000000000000000000000000000000000000000000000000000000000000000000000000000000000000000000000000000000000000000000000000000000000000000000000000000000000000000000000000000000000000000000000000000000000000000000000000000000000000000000000000000000000000000000000000000000000000000000000000000000000000000000000000000000000000000000000000
00000000000000000000000000000000000000000000000000000000000000000000000000000000000000000000000000000000000000000000000000000000000000000000000000000000000000000000000000000000000000000000000000000000000000000000000000000000000000000000000000000000000000000000000000000000000000000000000000000000000000000000000000000000000000000000000000000000000000000000000000000000000000
00000000000000000000000000000000000000000000000000000000000000000000000000000000000000000000000000000000000000000000000000000000000000000000000000000000000000000000000000000000000000000000000000000000000000000000000000000000000000000000000000000000000000000000000000000000000000000000000000000000000000000000000000000000000000000000000000000000000000000000000000000000000000
00000000000000000000000000000000000000000000000000000000000000000000000000000000000000000000000000000000000000000000000000000000000000000000000000000000000000000000000000000000000000000000000000000000000000000000000000000000000000000000000000000000000000000000000000000000000000000000000000000000000000000000000000000000000000000000000000000000000000000000000000000000000000
00000000000000000000000000000000000000000000000000000000000000000000000000000000000000000000000000000000000000000000000000000000000000000000000000000000000000000000000000000000000000000000000000000000000000000000000000000000000000000000000000000000000000000000000000000000000000000000000000000000000000000000000000000000000000000000000000000000000000000000000000000000000000
00000000000000000000000000000000000000000000000000000000000000000000000000000000000000000000000000000000000000000000000000000000000000000000000000000000000000000000000000000000000000000000000000000000000000000000000000000000000000000000000000000000000000000000000000000000000000000000000000000000000000000000000000000000000000000000000000000000000000000000000000000000000000
00000000000000000000000000000000000000000000000000000000000000000000000000000000000000000000000000000000000000000000000000000000000000000000000000000000000000000000000000000000000000000110000000000000000000000000000000000000000000000000000000000000000000000000000000000000000000000000000000000000000000000000000000000000000000000000000000000000000600000000000000000000000000
00000000000000000000000000000000000000000000000000000100000000000000000000000000000000000000000000000000000000000000000000000000000000000000000000000000000000000000000000000001111000000000000000000000000000000000000000000000000000000000000000000000000000000000000000000000000000000000000000000000000000000000000000000000000000000000000000000000006660000000000000000000000000
00000000000000000000000000000000000000000000000000000100000000000000000000000000000000000000000000000000000001100000001000010001100000000000000000000000000000000000000011000000000000000000000000000000000000000000000000000000000000000000000000000000000000000000000000000000000000000000000000000000000000000000000000000000000000000000000000000000006660000000000000000000000000
00000000000000000000000000000000000000011111100111111001110000000000000000000000000000000000000000000000011000000000000000000000000110000000000000000000000000000000110000000000000000000110000000000000000000000000000000000000000000000000000000000000000000000000005000050000050000000000000000000000000000000000000000000000000000000000000000000000044444000000000000000000000000
00000000000000000000000000000000000001122222200222222000000000000000000000000000000000000000000000001110000000000000000000000000000000011100000000000000000000111000000000000000000000000000000000000000000000000000000000000000000000000000000000000000000000000111111011111111111111000000000000000000000000000000000000000000000000000000000000000000044444000000000000000000000000
00000000000000000000000000000000001002222222200222222000000001100000000000000000000000000000000111000000000000000000000011000000000000000000000000000000001100000000000000000000000000000000000000000000005000000000005000000000000000000000000000000000000000000000002000000000000001111111000000000000000000000000011100000000000000000000000000000600044444000600000000000000000000
00000000000000000000000000000001002002222222200222222000000000000000000000000000000000000000000000000000000000000000000000000000000000000000000100500100000000000000000000000000000000000000000000110001111111000011111111100000000000000000000550000000000000020000002000000000000000000000111111000000000011000000000000110000000000000000000000004440044444004440000000000000000000
00000000000000000000000000001002002002222222255222222000000000000011000000000000000000000011011000011011011000000000100000000100000000000000000200200200000000000000000000000000000000500000001100000000000000210010000000000000000000000001110110111000000000020000002000000000000500000000000000111110005000001100000000000001000000000000000000004644443334444640000000000000000000
00000000000000000000000001002002002002000000022000000000000000000000000000000000000000000000000005000000000000000000200000000200000000000000000011011000000000000000000000000000000500201111000000000000000000011000000000000111000000000012220000222100000000020001112000111111111111111110000000000001111000000000000000000000001000000000000000004644443334444640000000000000000000
00000000000000000000001002002002002002000000022000000000000000000000000110000000500000000000000002000000000000000000200000000200000000050000000000100000000000000050000050005000500200200000000000000000000000000000000000000000500000000122220000222210005000000000000000000000000000000002000055555555555555555555555555555555555551110000000000004444443334444440000000000000000000
11111111111111111111111111111111111111111111111111111111111111111111111111111111111111111111111111111111111111111111111000011111111111111111111111111111111111111111111111111111111111111111111111111111111111111111111111111111111111111111110000111111111111111111111111111111111111111111111111111111111111111111111111111111111111111111111111111111111111111111111111111111111111
22222222222222222222222222222222222222222222222222222222222222222222222222222222222222222222222222222222222222222222222000022222222222222222222222222222222222222222222222222222222222222222222222222222222222222222222222222222222222222222220000222222222222222222222222222222222222222222222222222222222222222222222222222222222222222222222222222222222222222222222222222222222222
22222222222222222222222222222222222222222222222222222222222222222222222222222222222222222222222222222222222222222222222000022222222222222222222222222222222222222222222222222222222222222222222222222222222222222222222222222222222222222222220000222222222222222222222222222222222222222222222222222222222222222222222222222222222222222222222222222222222222222222222222222222222222
22222222222222222222222222222222222222222222222222222222222222222222222222222222222222222222222222222222222222222222222000022222222222222222222222222222222222222222222222222222222222222222222222222222222222222222222222222222222222222222220000222222222222222222222222222222222222222222222222222222222222222222222222222222222222222222222222222222222222222222222222222222222222
22222222222222222222222222222222222222222222222222222222222222222222222222222222222222222222222222222222222222222222222000022222222222222222222222222222222222222222222222222222222222222222222222222222222222222222222222222222222222222222220000222222222222222222222222222222222222222222222222222222222222222222222222222222222222222222222222222222222222222222222222222222222222